

  111111111111111111
 1100000S000000000011
1110000000000000f00111
 11000001111100000011
  111111     1111111
